Species	Trait
Abscondita_terminalis	Both
Acanthaster_planci	Both
Acanthocheilonema_viteae	NAMPT_Only
Acromyrmex_charruanus	PNC1_Only
Acromyrmex_echinatior	PNC1_Only
Acromyrmex_heyeri	PNC1_Only
Acromyrmex_insinuator	PNC1_Only
Acropora_digitifera	Both
Acropora_millepora	Both
Actinia_tenebrosa	Both
Acyrthosiphon_pisum	PNC1_Only
Adineta_ricciae	Both
Adineta_steineri	Both
Aedes_aegypti	PNC1_Only
Aedes_albopictus	PNC1_Only
Aethina_tumida	PNC1_Only
Agrilus_planipennis	PNC1_Only
Amphibalanus_amphitrite	PNC1_Only
Amphimedon_queenslandica	NAMPT_Only
Ampulex_compressa	PNC1_Only
Amyelois_transitella	PNC1_Only
Ancylostoma_caninum	NAMPT_Only
Ancylostoma_ceylanicum	Both
Ancylostoma_duodenale	NAMPT_Only
Angiostrongylus_cantonensis	NAMPT_Only
Angiostrongylus_costaricensis	NAMPT_Only
Anisakis_simplex	Both
Anneissia_japonica	Both
Anopheles_albimanus	PNC1_Only
Anopheles_arabiensis	PNC1_Only
Anopheles_coluzzii	PNC1_Only
Anopheles_darlingi	PNC1_Only
Anopheles_sinensis	PNC1_Only
Anopheles_stephensi	PNC1_Only
Anoplophora_glabripennis	PNC1_Only
Aphidius_gifuensis	PNC1_Only
Aphis_craccivora	PNC1_Only
Aphis_glycines	PNC1_Only
Aphis_gossypii	PNC1_Only
Apis_cerana	PNC1_Only
Apis_cerana_cerana	PNC1_Only
Apis_dorsata	PNC1_Only
Apis_florea	PNC1_Only
Apis_mellifera	PNC1_Only
Apis_mellifera_caucasica	PNC1_Only
Aplysia_californica	Both
Apolygus_lucorum	PNC1_Only
Apostichopus_japonicus	NAMPT_Only
Araneus_ventricosus	PNC1_Only
Arctia_plantaginis	PNC1_Only
Argiope_bruennichi	PNC1_Only
Aricia_agestis	PNC1_Only
Armadillidium_nasatum	PNC1_Only
Armadillidium_vulgare	PNC1_Only
Asbolus_verrucosus	PNC1_Only
Asterias_rubens	Both
Athalia_rosae	PNC1_Only
Atta_cephalotes	PNC1_Only
Atta_colombica	PNC1_Only
Aurelia_coerulea	PNC1_Only
Bactrocera_dorsalis	PNC1_Only
Bactrocera_oleae	PNC1_Only
Bactrocera_tryoni	PNC1_Only
Batillaria_attramentaria	Both
Belonocnema_treatae	PNC1_Only
Bemisia_tabaci	PNC1_Only
Bicyclus_anynana	PNC1_Only
Biomphalaria_glabrata	Both
Bombus_bifarius	PNC1_Only
Bombus_impatiens	PNC1_Only
Bombus_terrestris	PNC1_Only
Bombus_vancouverensis_nearcticus	PNC1_Only
Bombus_vosnesenskii	PNC1_Only
Bombyx_mori	PNC1_Only
Brachionus_calyciflorus	PNC1_Only
Brachionus_plicatilis	PNC1_Only
Bradysia_coprophila	PNC1_Only
Bradysia_odoriphaga	PNC1_Only
Branchiostoma_belcheri	Both
Branchiostoma_floridae	Both
Brugia_malayi	NAMPT_Only
Brugia_pahangi	NAMPT_Only
Brugia_timori	NAMPT_Only
Bugula_neritina	NAMPT_Only
Bursaphelenchus_okinawaensis	PNC1_Only
Bursaphelenchus_xylophilus	PNC1_Only
Caenorhabditis_bovis	PNC1_Only
Caenorhabditis_brenneri	PNC1_Only
Caenorhabditis_briggsae	PNC1_Only
Caenorhabditis_elegans	PNC1_Only
Caenorhabditis_nigoni	PNC1_Only
Caenorhabditis_remanei	PNC1_Only
Caligus_clemensi	PNC1_Only
Caligus_rogercresseyi	PNC1_Only
Callosobruchus_maculatus	PNC1_Only
Camponotus_floridanus	PNC1_Only
Candidula_unifasciata	Both
Capitella_teleta	Both
Capsaspora_owczarzaki_ATCC_30864	NAMPT_Only
Centruroides_sculpturatus	PNC1_Only
Cephus_cinctus	PNC1_Only
Ceratina_calcarata	PNC1_Only
Ceratitis_capitata	PNC1_Only
Ceratosolen_solmsi_marchali	PNC1_Only
Chelonus_insularis	PNC1_Only
Chionoecetes_opilio	Both
Cimex_lectularius	PNC1_Only
Cinara_cedri	PNC1_Only
Cloeon_dipterum	PNC1_Only
Clonorchis_sinensis	Both
Clunio_marinus	PNC1_Only
Clytia_hemisphaerica	PNC1_Only
Contarinia_nasturtii	PNC1_Only
Copidosoma_floridanum	PNC1_Only
Coptotermes_formosanus	PNC1_Only
Cotesia_chilonis	PNC1_Only
Cotesia_congregata	PNC1_Only
Crassostrea_gigas	Both
Crassostrea_virginica	Both
Cryptotermes_secundus	PNC1_Only
Ctenocephalides_felis	PNC1_Only
Culex_pipiens_pallens	PNC1_Only
Culex_quinquefasciatus	PNC1_Only
Cylicostephanus_goldi	NAMPT_Only
Cyphomyrmex_costatus	PNC1_Only
Cyprideis_torosa	PNC1_Only
Danaus_plexippus_plexippus	PNC1_Only
Daphnia_magna	PNC1_Only
Daphnia_pulex	PNC1_Only
Darwinula_stevensoni	Both
Dendroctonus_ponderosae	PNC1_Only
Dendronephthya_gigantea	PNC1_Only
Dermacentor_silvarum	Both
Dermatophagoides_pteronyssinus	PNC1_Only
Diabrotica_virgifera_virgifera	PNC1_Only
Diachasma_alloeum	PNC1_Only
Diaphorina_citri	PNC1_Only
Dibothriocephalus_latus	NAMPT_Only
Dictyocaulus_viviparus	NAMPT_Only
Didymodactylos_carnosus	Both
Dimorphilus_gyrociliatus	Both
Dinoponera_quadriceps	PNC1_Only
Dinothrombium_tinctorium	PNC1_Only
Diploscapter_pachys	Both
Diuraphis_noxia	PNC1_Only
Dracunculus_medinensis	NAMPT_Only
Drosophila_albomicans	PNC1_Only
Drosophila_ananassae	PNC1_Only
Drosophila_arizonae	PNC1_Only
Drosophila_biarmipes	PNC1_Only
Drosophila_bipectinata	PNC1_Only
Drosophila_busckii	PNC1_Only
Drosophila_elegans	PNC1_Only
Drosophila_erecta	PNC1_Only
Drosophila_eugracilis	PNC1_Only
Drosophila_ficusphila	PNC1_Only
Drosophila_grimshawi	PNC1_Only
Drosophila_guanche	PNC1_Only
Drosophila_hydei	PNC1_Only
Drosophila_innubila	PNC1_Only
Drosophila_kikkawai	PNC1_Only
Drosophila_melanogaster	PNC1_Only
Drosophila_miranda	PNC1_Only
Drosophila_mojavensis	PNC1_Only
Drosophila_navojoa	PNC1_Only
Drosophila_novamexicana	PNC1_Only
Drosophila_obscura	PNC1_Only
Drosophila_persimilis	PNC1_Only
Drosophila_rhopaloa	PNC1_Only
Drosophila_sechellia	PNC1_Only
Drosophila_simulans	PNC1_Only
Drosophila_subobscura	PNC1_Only
Drosophila_subpulchrella	PNC1_Only
Drosophila_suzukii	PNC1_Only
Drosophila_takahashii	PNC1_Only
Drosophila_virilis	PNC1_Only
Drosophila_willistoni	PNC1_Only
Drosophila_yakuba	PNC1_Only
Dufourea_novaeangliae	PNC1_Only
Echinococcus_granulosus	NAMPT_Only
Echinococcus_multilocularis	NAMPT_Only
Echinostoma_caproni	PNC1_Only
Elysia_chlorotica	Both
Elysia_marginata	Both
Enterobius_vermicularis	NAMPT_Only
Ephemera_danica	PNC1_Only
Ephydatia_muelleri	NAMPT_Only
Eufriesea_mexicana	PNC1_Only
Eumeta_japonica	PNC1_Only
Euroglyphus_maynei	PNC1_Only
Eurytemora_affinis	Both
Exaiptasia_diaphana	Both
Exaiptasia_pallida	Both
Fasciola_gigantica	Both
Fasciola_hepatica	NAMPT_Only
Fasciolopsis_buski	NAMPT_Only
Folsomia_candida	PNC1_Only
Fonticula_alba	NAMPT_Only
Fopius_arisanus	PNC1_Only
Formica_exsecta	PNC1_Only
Frankliniella_occidentalis	PNC1_Only
Frieseomelitta_varia	PNC1_Only
Galendromus_occidentalis	PNC1_Only
Gigantopelta_aegis	Both
Glossina_fuscipes	PNC1_Only
Gongylonema_pulchrum	NAMPT_Only
Gonioctena_quinquepunctata	PNC1_Only
Habropoda_laboriosa	PNC1_Only
Haemonchus_contortus	Both
Haemonchus_placei	Both
Halicephalobus_sp._NKZ332	PNC1_Only
Halichondria_panicea	NAMPT_Only
Haliclona_amboinensis	NAMPT_Only
Haliclona_tubifera	NAMPT_Only
Halisarca_dujardini	NAMPT_Only
Halisarca_dujardinii	NAMPT_Only
Halyomorpha_halys	PNC1_Only
Harpegnathos_saltator	PNC1_Only
Helicoverpa_armigera	PNC1_Only
Heligmosomoides_polygyrus	Both
Heliothis_virescens	PNC1_Only
Helobdella_robusta	Both
Henneguya_salminicola	PNC1_Only
Hermetia_illucens	PNC1_Only
Homarus_americanus	Both
Homo_sapiens	NAMPT_Only
Hyalella_azteca	PNC1_Only
Hydatigera_taeniaeformis	NAMPT_Only
Hydra_vulgaris	PNC1_Only
Hymenolepis_diminuta	NAMPT_Only
Hymenolepis_microstoma	NAMPT_Only
Hyposmocoma_kahamanoa	PNC1_Only
Hypsibius_dujardini	PNC1_Only
Ignelater_luminosus	PNC1_Only
Intoshia_linei	NAMPT_Only
Ixodes_persulcatus	Both
Ixodes_scapularis	Both
Laodelphax_striatellus	PNC1_Only
Lasius_niger	PNC1_Only
Lepeophtheirus_salmonis	PNC1_Only
Leptinotarsa_decemlineata	PNC1_Only
Leptotrombidium_deliense	PNC1_Only
Leucosolenia_complicata	Both
Limulus_polyphemus	Both
Linepithema_humile	PNC1_Only
Lingula_anatina	Both
Litomosoides_sigmodontis	NAMPT_Only
Loa_loa	NAMPT_Only
Lottia_gigantea	Both
Lucilia_cuprina	PNC1_Only
Lucilia_sericata	PNC1_Only
Lytechinus_variegatus	Both
Macrostomum_lignano	PNC1_Only
Manduca_sexta	PNC1_Only
Maniola_hyperantus	PNC1_Only
Medioppia_subpectinata	Both
Megachile_rotundata	PNC1_Only
Megalopta_genalis	PNC1_Only
Melanaphis_sacchari	PNC1_Only
Melipona_quadrifasciata	PNC1_Only
Mesocestoides_corti	NAMPT_Only
Microplitis_demolitor	PNC1_Only
Mizuhopecten_yessoensis	Both
Mnemiopsis_leidyi	PNC1_Only
Monomorium_pharaonis	PNC1_Only
Monosiga_brevicollis_MX1	Both
Mus_musculus	NAMPT_Only
Musca_domestica	PNC1_Only
Mytilus_coruscus	Both
Mytilus_edulis	Both
Mytilus_galloprovincialis	Both
Myzus_persicae	PNC1_Only
Nasonia_vitripennis	PNC1_Only
Necator_americanus	NAMPT_Only
Nematostella_vectensis	Both
Neodiprion_lecontei	PNC1_Only
Nicrophorus_vespilloides	PNC1_Only
Nilaparvata_lugens	PNC1_Only
Nippostrongylus_brasiliensis	Both
Nomia_melanderi	PNC1_Only
Notodromas_monacha	Both
Nylanderia_fulva	PNC1_Only
Nymphon_striatum	PNC1_Only
Octopus_bimaculoides	Both
Octopus_sinensis	Both
Odontomachus_brunneus	PNC1_Only
Oesophagostomum_dentatum	Both
Oikopleura_dioica	NAMPT_Only
Onchocerca_flexuosa	NAMPT_Only
Onchocerca_ochengi	NAMPT_Only
Onthophagus_taurus	PNC1_Only
Ooceraea_biroi	PNC1_Only
Operophtera_brumata	PNC1_Only
Opisthorchis_felineus	Both
Opisthorchis_viverrini	Both
Oppiella_nova	Both
Orbicella_faveolata	NAMPT_Only
Orchesella_cincta	PNC1_Only
Orussus_abietinus	PNC1_Only
Oryctes_borbonicus	PNC1_Only
Oscarella_carmela	NAMPT_Only
Osmia_bicornis_bicornis	PNC1_Only
Osmia_lignaria	PNC1_Only
Ostrinia_furnacalis	PNC1_Only
Papilio_machaon	PNC1_Only
Papilio_polytes	PNC1_Only
Papilio_xuthus	PNC1_Only
Paragonimus_heterotremus	NAMPT_Only
Paragonimus_kellicotti	Both
Paragonimus_miyazakii	Both
Paragonimus_westermani	Both
Pararge_aegeria	PNC1_Only
Parasteatoda_tepidariorum	PNC1_Only
Parnassius_apollo	PNC1_Only
Patiria_miniata	Both
Pecten_maximus	Both
Pediculus_humanus_corporis	PNC1_Only
Penaeus_monodon	Both
Penaeus_vannamei	Both
Phallusia_mammillata	PNC1_Only
Photinus_pyralis	PNC1_Only
Pieris_macdunnoughi	PNC1_Only
Pieris_rapae	PNC1_Only
Plakobranchus_ocellatus	Both
Pleurobrachia_bachei	PNC1_Only
Plutella_xylostella	PNC1_Only
Pocillopora_damicornis	Both
Pogonomyrmex_barbatus	PNC1_Only
Polistes_canadensis	PNC1_Only
Polistes_dominula	PNC1_Only
Pollicipes_pollicipes	PNC1_Only
Polypedilum_vanderplanki	PNC1_Only
Pomacea_canaliculata	Both
Portunus_trituberculatus	Both
Priapulus_caudatus	Both
Pristionchus_pacificus	Both
Pseudoatta_argentina	PNC1_Only
Pseudomyrmex_gracilis	PNC1_Only
Puccinia_graminis	PNC1_Only
Ramazzottius_varieornatus	PNC1_Only
Rhagoletis_zephyria	PNC1_Only
Rhipicephalus_microplus	Both
Rhipicephalus_sanguineus	Both
Rhizophagus_irregularis_DAOM_181602=DAOM_197198	NAMPT_Only
Rhopalosiphum_maidis	PNC1_Only
Rhynchophorus_ferrugineus	PNC1_Only
Rotaria_magnacalcarata	Both
Rotaria_socialis	Both
Rotaria_sordida	Both
Rotaria_sp._Silwood1	Both
Rotaria_sp._Silwood2	Both
Saccharomyces_cerevisiae_S288C	PNC1_Only
Saccoglossus_kowalevskii	Both
Salpingoeca_rosetta	Both
Sarcophaga_bullata	PNC1_Only
Sarcoptes_scabiei	PNC1_Only
Scaptodrosophila_lebanonensis	PNC1_Only
Schistocephalus_solidus	NAMPT_Only
Schistosoma_bovis	NAMPT_Only
Schistosoma_curassoni	NAMPT_Only
Schistosoma_haematobium	NAMPT_Only
Schistosoma_japonicum	NAMPT_Only
Schistosoma_mansoni	NAMPT_Only
Schistosoma_margrebowiei	NAMPT_Only
Schistosoma_mattheei	NAMPT_Only
Sepia_pharaonis	Both
Sipha_flava	PNC1_Only
Sitophilus_oryzae	PNC1_Only
Solenopsis_invicta	PNC1_Only
Sparganum_proliferum	NAMPT_Only
Sphaeroforma_arctica_JP610	PNC1_Only
Spirometra_erinaceieuropaei	NAMPT_Only
Spizellomyces_punctatus_DAOM_BR117	Both
Spodoptera_exigua	PNC1_Only
Spodoptera_frugiperda	PNC1_Only
Spodoptera_litura	Both
Stegodyphus_dumicola	PNC1_Only
Stegodyphus_mimosarum	PNC1_Only
Steinernema_carpocapsae	Both
Stomoxys_calcitrans	PNC1_Only
Strongylocentrotus_purpuratus	Both
Strongyloides_ratti	Both
Strongylus_vulgaris	Both
Styela_clava	PNC1_Only
Stylophora_pistillata	Both
Suberites_domuncula	NAMPT_Only
Sycon_ciliatum	Both
Taenia_asiatica	NAMPT_Only
Teladorsagia_circumcincta	NAMPT_Only
Teleopsis_dalmanni	PNC1_Only
Temnothorax_curvispinosus	PNC1_Only
Temnothorax_longispinosus	PNC1_Only
Tetranychus_urticae	PNC1_Only
Thelazia_callipaeda	NAMPT_Only
Thelohanellus_kitauei	PNC1_Only
Thrips_palmi	PNC1_Only
Tigriopus_californicus	Both
Timema_californicum	PNC1_Only
Timema_shepardi	PNC1_Only
Toxocara_canis	Both
Trachymyrmex_cornetzi	PNC1_Only
Trachymyrmex_septentrionalis	PNC1_Only
Trachymyrmex_zeteki	PNC1_Only
Tribolium_castaneum	PNC1_Only
Trichinella_britovi	NAMPT_Only
Trichinella_murrelli	NAMPT_Only
Trichinella_nativa	NAMPT_Only
Trichinella_nelsoni	NAMPT_Only
Trichinella_papuae	NAMPT_Only
Trichinella_patagoniensis	NAMPT_Only
Trichinella_pseudospiralis	NAMPT_Only
Trichinella_sp._T9	NAMPT_Only
Trichinella_spiralis	NAMPT_Only
Trichinella_zimbabwensis	NAMPT_Only
Trichobilharzia_regenti	NAMPT_Only
Trichogramma_brassicae	PNC1_Only
Trichogramma_pretiosum	PNC1_Only
Trichomalopsis_sarcophagae	PNC1_Only
Trichoplax_adhaerens	NAMPT_Only
Trichoplax_sp._H2	NAMPT_Only
Trichoplusia_ni	PNC1_Only
Trichuris_suis	NAMPT_Only
Trichuris_trichiura	NAMPT_Only
Trinorchestia_longiramus	PNC1_Only
Tropilaelaps_mercedesae	PNC1_Only
Vanessa_tameamea	PNC1_Only
Varroa_destructor	PNC1_Only
Vespa_mandarinia	PNC1_Only
Vespula_germanica	PNC1_Only
Vespula_pensylvanica	PNC1_Only
Vespula_vulgaris	PNC1_Only
Vollenhovia_emeryi	PNC1_Only
Wasmannia_auropunctata	PNC1_Only
Wuchereria_bancrofti	NAMPT_Only
Xestospongia_testudinaria	Both
Zerene_cesonia	PNC1_Only
Zeugodacus_cucurbitae	PNC1_Only
Zootermopsis_nevadensis	PNC1_Only